#################
##   #    #######
## P #       O ##
##          #####
#           #####
#################