############
# A        #
######    ##
#   @      #
#          #
#   @      #
#          #
#        @ #
#   ###    #
#    O#    #
############ 