########################################################
##        ##           @                      ##      ##
## A      ##  ###      ########  ########## @ ##      ##
##   ##       ##            @                         ##
##   ##       ##           ##       ############      ##
##   @###########################  ################  ###
##              @  ##     ##    @     ##              ##
##      ##    ##        O ##   ##             ##      ##
##    ###    ###############  #####################   ##
##    #########     @     ##  ###            #   #   ###
##   ##          ##   ##              ##@             ##
##   #      #######   ########      ####################
##   @            ##                                ####
######################################################## 