######################
# A        ##       ##
######    ###  ##  ###
#   @      ##  ##  ###
#              #   ###
#          #####   ###
#    @     ##    #####
######     ##  #######
# O #                #
#          ###########
###################### 