############
# A        #
###### @  ##
#          #
#          #
#          #
#          #
#          #
#   ###    #
#   #O#    #
############