     ########################      
     ##                    ##      
     ##   ##  ###########  ##      
#######       @    ###     ##      
##        ##       ###     ##      
##  ##################   ##########
##      ##         ##      ##   O##
##A     ##O ###       @        ####
################################### 