########################################################
##   ##   ##                 ##               ##      ##
## A ##   ##  ###########    ##  ##########   ##      ##
##   ##                     @                         ##
##                 ####    ##       ############      ##
################################  ################  ####
##                 ##               ####              ##
##O     ##    ##        @      ##             ##      ##
######################################################## 