########################################################
##        ##           @                      ##      ##
## A      ##  ###      ########  ########## @ ##      ##
##   ##       ##            @                         ##
##   ##       ##           ##       ############      ##
#################################  ################  ###
##                 ##     ##          ##              ##
##      ##    ##        O ##   ##             ##      ##
##    ###    ###############  #####################   ##
##    #########           ##  ###            #   #   ###
##   ##          ##   ##              ##@             ##
##   #      #######   ########      ####################
##   @            ##                                ####
######################################################## 