#############################      
##   ##   ##               ##      
##   ##   ##  ###########  ##      
##   ##                    ##      
##                 ###     ##      
######################   ##########
##                 ##      ##    ##
##A     ##    ##               ####
################################### 