########################################################
##   ##   ##                 ##               ##      ##
## A ##   ##  ###########    ##  ##########   ##      ##
##   ##                                               ##
##                 ####    ##       ############      ##
#######################  ######  #################  ####
##                 ##      ##       ####              ##
##O     ##    ##               ##             ##      ##
########################################################