     ########################      
     ##   ##               ##      
     ##   ##  ###########  ##      
#######            ###     ##      
##        ##       ###     ##      
##  ##################   ##########
##      ##         ##      ##   O##
##A     ##O ###       @        ####
################################### 