     ########################      
     ##   ##               ##      
     ##   ##  ###########  ##      
#######            ###     ##      
##        ## @     ###     ##      
##  ##################   ##########
##      ##         ##      ##   O##
##A     ##O ###       @        ####
################################### 