######################
# A        ##       ##
######    ###  ##  ###
#   @      ##  ##  ###
#              #   ###
#      @   #####   ###
#          ##    #####
######   @ ##  #######
#                   @#
#    O#    ###########
###################### 