######################
# A        ##       ##
######    ###  ##  ###
#   @      ##  ##  ###
#              #   ###
#       @  #####   ###
#    @     ##    #####
######     ##  #######
# O #              @ #
#          ###########
###################### 