############
# A        #
######    ##
#          #
#          #
#          #
#          #
#          #
#   # #    #
#   #O#    #
############ 